2,3,2,2,3,2,2,2,3,3,1,2,1,2,3,2
1,0,0,0,0,0,0,0,0,0,6,0,0,0,0,3
2,0,0,0,0,0,0,0,0,0,6,0,0,0,0,2
2,0,0,0,0,0,6,0,0,3,0,0,0,0,0,3
3,0,6,0,0,0,0,6,0,1,0,0,3,1,1,1
1,0,0,0,0,0,0,0,0,3,0,0,0,0,0,3
1,0,0,3,2,1,2,3,1,2,0,0,0,0,6,4
2,6,6,0,0,0,0,0,0,2,0,0,0,0,6,4
1,0,0,0,0,0,0,0,0,1,2,2,3,3,3,2
1,0,0,0,0,0,0,6,6,2,0,0,0,0,0,1
2,2,3,2,2,1,2,0,0,2,1,2,3,3,3,1
3,0,0,0,0,0,0,0,0,0,0,0,0,0,0,1
4,0,6,0,0,0,0,6,0,0,0,0,0,6,0,3
4,0,6,0,0,0,0,0,6,0,0,0,0,6,0,2
2,0,0,0,0,0,0,0,0,0,0,0,0,0,0,2
2,3,1,1,3,1,3,3,3,3,1,3,1,1,2,2
