2,3,4,4,1,3,3,3
3,0,0,0,0,0,0,3
2,0,0,6,0,0,0,2
3,0,0,0,6,0,0,1
2,6,0,0,0,2,1,1
4,0,0,0,0,1,-1,-1
4,0,6,0,0,1,-1,-1
1,2,1,3,3,3,-1,-1
